20,20
1
00000000000000000000
00022000000000000000
00200100000000000000
00100010000000000000
00200003111112000000
00030000000000100000
00030000000000010000
00100000000000002000
02000000000000001000
01000000000000001000
02000000000000001000
00211300000000002000
00000030000000010000
00000030000000100000
00000100000312000000
00002000003000000400
00001000001000001000
00001000003000010000
0000X000000311300000
00000000000000000000

# start at X, end at 4
# 1 = forward, 2 = right, 3 =left
