20,20
0
00000000000000000000
00000040002111200000
00000100010000020000
00001000100000010000
00010002000000020000
00300001000000100000
00100001000001000000
00100002000030000000
00300000100010000000
00010000030010000000
00002000010030000000
00001000010001000000
00002000010000200000
00010000010000100000
00300000010000100000
00100000010000100000
00300000030000100000
00010000100000100000
00003113000000X00000
00000000000000000000

# start at X, end at 4
# 1 = forward, 3 = right, 2 =left
