20,20
0
00021200000000000400
00200010000000000100
00100003111200000300
00200000000010001000
00010000000003130000
00002111300000000000
00000000010000000000
00000000001000000000
00002120000100000000
00010001000021130000
00200000200000001000
00100000100000000300
00200000100000000100
00010000100000000100
00001000300000000300
00000300010000001000
00000100001000010000
00000100000311300000
00000X00000000000000
00000000000000000000

# start at X, end at 4
# 1 = forward, 2 = right, 3 =left
