30,30
0
000000000000000000000000000000
000000311300000000000000000000
000003000010000000000000000000
000001000001000000000000000000
000001000000100000000000000000
000003000000010000000000000000
000000100000001000000000000000
000000010000000100000000000000
000000001000000010000000000000
000000000311120001000000000000
000000000000001000211300000000
000000000000000100000010000000
000000000000000010000001000000
000000000000000002000000100000
000000000000000001000000010000
000000000000000001000000004000
000000000000000001000000000000
000000000000000002000000000000
000000000000000010000000000000
000000000000000100000000000000
000000000000001000000000000000
000000000031120000000000000000
000000000100000000000000000000
000000001000000000000000000000
000000030000000000000000000000
000000010000000000000000000000
000000010000000000000000000000
000000010000000000000000000000
0000000X0000000000000000000000
000000000000000000000000000000

# first line, x,y of map
# second line, inital facing direction, 0 = North
# start at X, end at 4