20,20
0
00000000000000000000
00000040003111300000
00000100010000030000
00001000100000010000
00010003000000030000
00200001000000100000
00100001000001000000
00100003000020000000
00200000100010000000
00010000020010000000
00003000010020000000
00001000010001000000
00003000010000300000
00010000010000100000
00200000010000100000
00100000010000100000
00200000020000100000
00010000100000100000
00002112000000X00000
00000000000000000000

# start at X, end at 4
# 1 = forward, 2 = right, 3 =left
