# comments start with #, but # must be first non whitespace in line
name : patchyA
0000000000000000000000000000000000000000000000000000000000000000000000000000000000000000000000000000
0000000000000000000000000000000000000000000000000000000000000000000000000000000000000000000000000000
0000000000000000000000000000000000000000000000000000000000000000000000000000000000000000000000000000
0000000000000000000000000000000000000000000000000000000000000000000000000000000000000000000000000000
0000000000000000000000000000000000000000000000000000000000000000000000000000000000000000000000000000
0000000000000000000000000000000000000000000000000000000000000000011110000000000000000000000000000000
0000000000000000000000000000000000000000000000000000000000000001111111100000000000000000000000000000
0000000000000000000000000000000000000000111000000000000011111111111111110000000000000000000000000000
0000000000000000000000000000000000000111111110000000011111111111111111111000000000000000000000000000
0000000000000000000000000000000000011111111111110001111111111111111111111100000000000000000000000000
0000000000000000000000000000000011111111111111110001111111111111111111111110000000000000000000000000
0000000000000000000000000000000111111111111111111000111111111111111111111111000000000000000000000000
0000000000000000000000000000001111111111111111111000111111111111111111111111000000000000000000000000
0000000000000000000000000000001111111111111111111000111111111111111111111111100000000000000000000000
0000000000000000000000000000001111111111111111111000111111111111111111111111000000000000000000000000
0000000000000000000000000000000111111111111111111000111111111111111111111110000000000000000000000000
0000000000000000000000000000000111111111111111111000111111111111111111111100000000000000000000000000
0000000000000000000000000000000011111111111111111000111111111111111111111000000000000000000000000000
0000000000000000000000000000000001111111111111111000111111111111111111111000000000000000000000000000
0000000000000000000000000000000000001111111111111000111111111111111111110000000000000000000000000000
0000000000000000000000000000000000000001111111110001111111111111111111100000000000000000000000000000
0000000000000000000000000000000000000000001111111111111111111111111110000000000000000000000000000000
0000000000000000000000000000000000000000001111111111111111111111111111000000000000000000000000000000
0000000000000000000000000000000000011111100011111111111111111111111111100000000000000000000000000000
0000000000000000000000000000000000001111110001111111111111111111111111000000000000000000000000000000
0000000000000000000000000000000001111111111100011111111111111111111110000000000000000000000000000000
0000000000000000000000000000000111111111111111111111111111111111111110000000000000000000000000000000
0000000000000000000000000000000001111111111111111111111111111111111110000000000000000000000000000000
0000000000000000000000000000000001111111111111111111111111111111111111000000000000000000000000000000
0000000000000000000000000000000011111111111111111111111111111111111111100000000000000000000000000000
0000000000000000000000000000000001111111111111111111111111111111111111111100000000000000000000000000
0000000000000000000000000000000001111111111111111111111111111100011111111100000000000000000000000000
0000000000000000000000000000000000111111111111111111111111111100000111111100000000000000000000000000
0000000000000000000000000000000000011111111111111111111111111000000001111110000000000000000000000000
0000000000000000000000000000000000000000111111111111111111110000000000011110000000000000000000000000
0000000000000000000000000000000000000000001111111111111110000000000000000111000000000000000000000000
0000000000000000000000000000000000000000001111111111111000000000000000000000000000000000000000000000
0000000000000000000000000000000000000000011111111110000000000000000000000000000000000000000000000000
0000000000000000000000000000000000000000001111111000000000000000000000000000000000000000000000000000
0000000000000000000000000000000000000000000011111000000000000000000000000000000000000000000000000000
0000000000000000000000000000000000000000000000000000000000000000000000000000000000000000000000000000
0000000000000000000000000000000000000000000000000000000000000000000000000000000000000000000000000000
0000000000000000000000000000000000000000000000000000000000000000000000000000000000000000000000000000
0000000000000000000000000000000000000000000000000000000000000000000000000000000000000000000000000000
0000000000000000000000000000000000000000000000000000000000000000000000000000000000000000000000000000
+
0000000000000000000000000000000000000000000000000000000000000000000000000000000000000000000000000000
0000000000000000000000000000000000000000000000000000000000000000000000000000000000000000000000000000
0000000000000000000000000000000000000000000000000000000000000000000000000000000000000000000000000000
0000000000000000000000000000000000000000000000000000000000000000000000000000000000000000000000000000
0000000000000000000000000000000000000000000000000000000000000000000000000000000000000000000000000000
0000000000000000000000000000000000000000000000000000000000000000000000000000000000000000000000000000
0000000000000000000000000000000000000000000000000000000000000000000000000000000000000000000000000000
0000000000000000000000000000000000000000000000000000000000000000000000000000000000000000000000000000
0000000000000000000000000000000000000000000000000000000000000000000000000000000000000000000000000000
0000000000000000000000000000000000000000000000000000000000000000000000000000000000000000000000000000
0000000000000000000000000000000000000000000000000000000000000000000000000000000000000000000000000000
0000000000000000000000000000000000000000000000000000000000000000000000000000000000000000000000000000
0000000000000000000000000000000000000000000000000000000000000000000000000000000000000000000000000000
0000000000000000000000000000000000000000000000000000000000000000000000000000000000000000000000000000
0000000000000000000000000000000000000000000000000000000000000000000000000000000000000000000000000000
0000000000000000000000000000000000000000000000000000000000000000000000000000000000000000000000000000
0000000000000000000000000000000000000000000000000000000000000000000000000000000000000000000000000000
0000000000000000000000000000000000000000000000000000000000000000000000000000000000000000000000000000
0000000000000000000000000000000000000000000000000000000000000000000000000000000000000000000000000000
0000000000000000000000000000000000000000000000000000000000000000000000000000000000000000000000000000
0000000000000000000000000000000000000000000000000000000000000000000000000000000000000000000000000000
0000000000000000000000000000000000000000000000000000000000000000000000000000000000000000000000000000
0000000000000000000000000000000000000000000000000000000000000000000000000000000000000000000000000000
0000000000000000000000000000000000000000000000000000000000000000000000000000000000000000000000000000
0000000000000000000000000000000000000000000000000000000000000000000000000000000000000000000000000000
0000000000000000000000000000000000000000000000000000000000000000000000000000000000000000000000000000
0000000000000000000000000000000000000000000000000000000000000000000000000000000000000000000000000000
0000000000000000000000000000000000000000000000000000000000000000000000000000000000000000000000000000
0000000000000000000000000000000000000000000000000000000000000000000000000000000000000000000000000000
0000000000000000000000000000000000000000000000000000000000000000000000000000000000000000000000000000
0000000000000000000000000000000000000000000000000000000000000000000000000000000000000000000000000000
0000000000000000000000000000000000000000000011111000000000000000000000000000000000000000000000000000
0000000000000000000000000000000000000000000011111000000000000000000000000000000000000000000000000000
0000000000000000000000000000000000000000000011111000000000000000000000000000000000000000000000000000
0000000000000000000000000000000000000000000011111000000000000000000000000000000000000000000000000000
0000000000000000000000000000000000000000000000000000000000000000000000000000000000000000000000000000
0000000000000000000000000000000000000000000000000000000000000000000000000000000000000000000000000000
0000000000000000000000000000000000000000000000000000000000000000000000000000000000000000000000000000
0000000000000000000000000000000000000000000000000000000000000000000000000000000000000000000000000000
0000000000000000000000000000000000000000000000000000000000000000000000000000000000000000000000000000
0000000000000000000000000000000000000000000000000000000000000000000000000000000000000000000000000000
0000000000000000000000000000000000000000000000000000000000000000000000000000000000000000000000000000
0000000000000000000000000000000000000000000000000000000000000000000000000000000000000000000000000000
0000000000000000000000000000000000000000000000000000000000000000000000000000000000000000000000000000
0000000000000000000000000000000000000000000000000000000000000000000000000000000000000000000000000000
*